#  ##.  ##  
@  #        
   # $      
  #######   
   #  ###  #
   #       #
## ###   ###
#  #     #  
#       #   
### #       
###         