@.   ###
  #$ #  
###  #  
#  # #  
#      #
#  #  ##
#  ##   
#       
## .$ ##
###  ###