##   ##     
            
      #   ##
## ####  #@ 
#     #   $ 
#        # #
####  ###   
  ##  #     
  ##  #     
#  ###  ##  
#  #        
## # #      
##   #  # # 
##         .