@        #
 # #   #  
   #      
    ######
  #   # $.
  #       
# ##### ##
     #   #
  #  #   #
###  #####