@        #
  #   #  #
####  #  #
###   #   
#   # #   
      ### 
 ##  #.   
  #  # $  
  #  ###  