#@   #  ####
# .     #   
#### #      
###  #####  
#    #  #   
 $   #      
  #   ###   
   # .  #  #
#$ ###     #
  #  #   ###
  #  #   ###
  #      ###