#    ####
@     $ #
  #  ## #
### ##  #
  # ## ##
  # ##  #
    ###  
    .    
### . $ #