##      ##   
##   #   $   
## #### #  ##
@  ###  #    
     #    #  
# #  ##     #
        ### #
   #   ###   
   ###  ##  .
  #      ####
 ##      #   
  #  ## #    
           ##