   ######
 # #  ###
   #  ###
#  ## #@ 
##     $ 
#     #  
#  ## ###
#     ###
#      . 
######   