###         ##
@     #       
     ######   
   #    ######
  ##     #    
##### #     # 
###     .# ## 
# $   #### #  
   # ##### #$ 
   # ###      
      ## #    
#     ## #### 
##.   #  #    
##  #         