@ #### .  
       #$ 
  ####  . 
###  #  ##
###  #   #
###  ##  #
####     #
#### $   #
####    ##