#  #  ###  ###
@  #  #       
      #  #    
##   #   ###  
     #  ####  
    ########  
  # ##     # #
    ## #   #  
    ##        
#     #  ###  
#  #$    #.   
   #  #  #  # 
 ##   ###     
  #    #   #  
  ##       #  