###  #  ###
#    #     
# #####    
@ #   #### 
 ##     ## 
  #   # #  
#  ##   #  
   .      #
  #   #    
         # 
   # # #   
#        $ 
#     #    