##    .       
##$       #   
## ######   # 
@    #        
     #   #    
##   ##  #  # 
###  #  #  ## 
        #     
     # ##  ## 
 ####   ##    
   #          
   #       #  