     ##  ##
      $    
#### ##  . 
     #@  ##
 #   #     
     #   # 
# ####  ## 
   ###  #  
   ###  #  
##    ##   
##    ##   