#  . #   #
   $ #   #
.  ####  #
#$####  ##
#@   #  ##
###  # ###
##        
##   #    