@ ####   #   
  #    # #   
  #      #   
  #   #  ##  
     ### ##  
  #####  ##  
        ##   
#   #        
####### ##  #
###   # #####
           ##
   ##   # $ #
      ####   
      #.     
#        #   