@ ##  ###  
.  #    #  
#       #  
      #    
    #      
###     ###
    ##  #  
    ##     
##  ### #  
#  ###     
#      #$ #
######   ##