#   ###     
#   ###     
### #####   
###   ### ##
###   ###  #
@   #####  #
     ##   ##
  #  #      
  #     #   
  ### # ##  
  #   #     
###.$ ###   