###     #  #   
#    #  #      
# #  ####      
@    ###   #   
     ###       
##    ## #  #  
  ##     # #  #
         #    #
# ## #  .######
#      ##  ##  
           ##$ 
   ###      #  
###  #   #     
###          ##