   ####@ #
   #   $ #
## # #  ##
      #.  
  ##  #   
  ########
          
     #    