    ###  ######
    ###    #  #
#   ##   # #  #
  #  #     ##. 
     # #   ##  
#   ##     ##  
###    ###    #
#       ###    
#    #  ##  #  
### ####       
  # #### # #   
  # ####  $ #  
         #@ #  