#@     
#   .  
####  #
###   #
###  $#
####  #
#######