####  #  #   
@  #     #$  
   #  #  #   
#     ##    #
#    ###  #  
#  #####     
        #  # 
    #      # 
# #   # #  # 
  #         .
          #  