@     ######   
    # #  #     
##          # #
  ### # # ##  #
   #          #
   #  #       #
  ####   ####  
   #           
# $#  # #     #
#   ##  ##  ###
#    #      #  
##   #  ##     
#    ## #  #   
    .#       # 
        #  #   