  ####  #  #
     #      
  #     ##  
   ###  ## #
        ## #
 ##    ### #
 ### ##### #
  #     ## #
. #  #  ## #
# #######  #
#    #    $ 
###      #@ 