@ ##     
   #   # 
         
## #  #  
# .## #$ 
#  #  #  
#  # $###
#   . ###