##  ####. 
##  ###   
##  ### $ 
#  #     #
#     ####
      ####
   ###@ ##
 # #. $ ##
   #  ####
#     ####