#######
#   #  
#.  .$.
###  ##
###$$ #
###@  #