########
#    .##
#      .
# #  #  
#     ##
###   ##
@$ $  ##
      ##