####    #
###     #
###  #   
##  ##$ .
#    #  #
#    ####
## #    #
@  # $  #
   #  . #
     ####