#       #
#$$#    #
#  ### ##
#  ###   
@   .    
   ####  
#        
   #     
   #.  ##