######   
@ ##.$   
      #  
#  ######
#    ####
##   ####
###     .
#### ##  
###   ###
##   $   
##   #   