@ ###       #
  #          
 ## $ ###### 
       ##    
     #  #    
  ####  #  ##
  #  #   ##  
     #   #   
      #  #  #
#. ## ###  ##
## #    #    
#  #         
#  ###  ##   