  #      #     
  #  $ #       
  #  ####   ## 
#$  ###  ####  
@    ##  #     
     #   # #  #
## #     #     
##             
##   ##  # ### 
  #         #  
      # #   #  
   #     ## ###
#  # # .       
#       #   #  
# .#  ####  #  