####  ####    
#  #    #     
             #
     ####  #  
###  #  #  ## 
###     #  ## 
@ #     #     
 $  #   ####  
# ####  ####  
#  #  ##      
         # #  
  ##      . # 
  #           
    ##  #     