@.   ########
 $ $ ##    ##
###         #
#######  #  #
  #####     #
   ###     ##
## #     ####
#          ##
#  # #  #.  #
   # #       
   # #       
 ### #   ### 
     ###     